######....######
...###....###...
...#.##..##.#...
##.#.##..##.#.##
##.#........#.##
####........####
##.####..####.##
##...##..##...##
####.##..##.####
..##.##..##.##..
..##.##..##.##..
#.##.##..##.##.#

