##.#.#.##.#.#.##
.#.#.#....#.#.#.
.#.#.######.#.#.
.#.#........#.#.
.#.##########.#.
.#...######...#.
.###.######.###.
####.######.####
####.######.####
................
................
######....######

