#.##.##..##.##.#
..##.##..##.##..
..##..#..#..##..
.####.#..#.####.
.####.#..#.####.
....#.#..#.#....
....#.#..#.#....
#.#...#..#...#.#
#.#####..#####.#
..####....####..
..####....####..
######....######

