################
................
................
####.######.####
####.######.####
#......##......#
#.####.##.####.#
#.####.##.####.#
#.####.##.####.#
..####.##.####..
.#...#.##.#...#.
##.#.#.##.#.#.##

