######....######
...###....###...
...###....###...
#..#........#..#
#..#........#..#
#..#........#..#
#..............#
####........####
####........####
...#........#...
...#........#...
################

